111111111111
1P00000C0001
10000000v011
10v00C0001E1
111111111111