
111111111111
1P0000100001
110000000001
1v1000000001
110000000001
1000000000E1
100000000111
1010000001v1
11010C000101
111111111111
